backoriu_tamsusis	Bačkorių tamsusis	alaus_namai	lt
belmonto_ypatingas	Belmonto ypatingasis	belmontas	lt
belmonto_sviesus	Belmonto šviesusis	belmontas	lt
bernard_cerne	Bernard Černe	dolce_vita, alaus_studija	cz
birzu_sirvenos	Biržų Širvenos	b6, alaus_namai, obuolys	lt
bravaria	Bravaria	bravaria	lt
budweiser	Budweiser "BUDVAR"	busi_trecias, plieno_paukste, simo_baras, dolce_vita, alaus_studija, obuolys	cz
busi_trecias	Būsi Trečias	busi_trecias	lt
butautu_dvaro	Butautų Dvaro	mamutas	lt
chodovar	Chodovar	obuolys	lt
daujotu	Daujotų	alaus_namai	lt
dundulio	Dundulio	bermudai, alaus_namai	lt
ekstra_tvirtoves	Ekstra Tvirtovės	pilies_mene	lt
erdinger	Erdinger	bunte_gans, simo_baras, alaus_studija	de
franziskaner	Franziskaner	savas_kampas	de
grimbergen	Grimbergen	jalta	be
gubernijos_kvietinis	Gubernijos kvietinis	alaus_namai	lt
guiness	Guiness	alaus_studija, obuolys	ie
heineken	Heineken	pogo, savas_kampas, wall_street, alaus_studija	nl
hoegarden	Hoegarden	wall_street, obuolys	be
jovaru_snekutis	Jovarų šnekutis	bermudai	lt
kalnapilis_grand	Kalnapilis "Grand"	busi_trecias, pilies_mene, mamutas, obuolys	lt
kanapinis	Kanapinis tamsus	bermudai, obuolys	lt
katedros_medaus	Katedros Medaus	prie_katedros, dominink_karciama	lt
katedros_sviesusis	Katedros Šviesusis	prie_katedros, dominink_karciama	lt
katedros_tamsusis	Katedros Tamsusis	prie_katedros, dominink_karciama	lt
kozel	Kozel	obuolys,wall_street	cz
krusovice	Krušovice	blusyne, simo_baras, alaus_studija	cz
kunigaiksciu	Kunigaikščių	mamutas, keisti_zenklai	lt
murphys_stout	Murphy's stout	alaus_studija	ie
new_castle_brown_ale	Newcastle Brown Ale	alaus_studija	uk
pilies	Pilies	pilies_mene	lt
pogo	PoGO šviesusis	pogo	lt
raudonuju_dobilu	Raudonųjų Dobilų	chillout, alaus_namai	lt
rinkuskiu_proginis	Rinkuškių proginis	bermudai, alaus_namai	lt
samson	Samson	blusyne, pogo, plieno_paukste, alaus_studija	cz
staropramen	Staropramen	burito, obuolys	cz
svyturys_baltas	Švyturys "Baltas"	busi_trecias, pilies_mene, uzupio_picerija	lt
svyturys_baltijos	Švyturys "Baltijos"	molinis_asotis, mamutas	lt
svyturys_extra	Švyturys "Extra"	jalta, pilies_mene, alaus_baras_just, molinis_asotis, b6, uzupio_picerija, mamutas	lt
tauro_tradicinis	Tauro Tradicinis	mamutas	lt
tores	Tores gyvas nefiltruotas	tores	lt
tucher	Tucher	obuolys	de
utenos	utenos	pilies_mene, alaus_baras_just	lt
varniuku	Varniukų tamsusis	pogo, alaus_baras_pyli, alaus_namai	lt
veltins	Veltins	bunte_gans, alaus_studija, obuolys	de
velvet	Velvet	savas_kampas	cz
vilkmerges_tamsusis	Vilkmergės tamsusis	alaus_namai	lt
vilniaus_kvietinis	Vilniaus kvietinis	bermudai, pogo, obuolys	lt
vilniaus_nefiltr	Vilniaus nefiltruotas	bermudai, alaus_namai	lt
warsteiner	Warsteiner	bunte_gans, plieno_paukste, wall_street	de
zubr	Zubr	savas_kampas	cz
leffe	Leffe	obuolys	be
